  ______ 
 |M  *  |
 |O /|\ |
 |O ||| |
 |N' A `|
 |* / \ |
  ~~~~~~  